Monta tu propia bicicleta por primera vez con la bicicleta Paw Patrol de Nickelodeon con ruedas de entrenamiento.
Un marco de acero bajo y duradero permite un fácil acceso y control para los niños pequeños y un freno de pie permite la confianza al parar.
El protector de cadena brillante ayuda a proteger de rasguños y cortes, mientras que las ruedas de entrenamiento extraíbles ayudan a los ciclistas por primera vez a encontrar su equilibrio a su propio ritmo.
Esta bicicleta está llena de divertidas características temáticas de la Patrulla Canina como una placa de manillar frontal, asiento impreso con láser, protector de cadena y escombros, persecución y cubiertas de rueda de marisco
Esta bicicleta se envía lista para ser montada y es ideal para ciclistas de entre 4 y 7 años. Las ruedas miden 16 pulgadas.

*********************
Tipo de bicicleta	‎Bicicleta para niños
Rango de edad (descripción)	‎Kid
Marca	‎Nickelodeon
Cantidad de velocidades	‎1
Color	‎Azul
Tamaño de rueda	‎16 Pulgadas
Material del armazón	‎Aleación de acero.
Tipo de suspensión	‎Rígida
Características especiales	‎Rueda de entrenamiento
Componentes incluidos	‎Bicicleta
Talla	‎16"
Estilo de freno	‎Para pasear sin esfuerzo
Personajes de caricaturas	‎Patrulla Canina
Usos específicos del producto	‎Bicicleta de acera
Peso del producto	‎25 Libras
Estilo	‎Paw Patrol Bike Ruedas de 16 pulgadas
Nombre de modelo	‎Nickelodeon Bicicleta Paw Patrol
Dimensiones del paquete: largo x ancho x alto	‎37.8 x 16.8 x 7.9 pulgadas
Peso del paquete	‎11.98 Kilogramos
Nombre de la Marca	‎Nickelodeon
Descripción de la garantía	‎Vida útil limitada
Material	‎Acero
Usuarios sugeridos	‎niños unisex
Número de artículos	‎1
Fabricante	‎Pacific Cycle, Inc.
Número de parte	‎R0672
Tamaño	‎16"