✔️【Cuchillas de rodillo】Tu seguridad es nuestra prioridad. Nuestros patines cuentan con un marco de aluminio reforzado, proporcionan soportes seguros para el tobillo. También viene con encaje estándar, correa potente, hebilla de alta resistencia, ayuda a los niños o bebés a mantener el equilibrio, mantener el control y mejorar sus estabilidades. Estas cuchillas son adecuadas tanto para patinaje en interiores como exteriores.
✔️【4 tamaños ajustables】 Cada patín es ajustable hasta 4 tamaños más grandes simplemente pulsando el botón, no te preocupes por el crecimiento de los pies. Opciones disponibles ahora mismo: pequeño para niños pequeños (talla 28-33), mediano para niños grandes (talla 34-37). Las plantillas también se pueden cortar para adaptarse a tus patines de acuerdo con el tamaño de tus pies.


Talla	‎L
Color	‎verde azulado
Marca	‎KDJ
Material de la rueda	‎Poliuretano
Tipo de rueda	‎Rueda de patines en línea
Material de la suela	‎Cuero
Tipo de cierre	‎Cordones
Tamaño de rueda	‎70 Milímetros
Material	‎Cuero
Peso del producto	‎2.04 Kilogramos
Patrón	‎Liso
Dimensiones del paquete: largo x ancho x alto	‎15.51 x 13.27 x 6.65 pulgadas
Peso del paquete	‎2.39 Kilogramos
Nombre de la Marca	‎KDJ
Descripción de la garantía	‎Las cuchillas de rodillo vienen con servicio de cambio gratuito de 30 días y garantía de 12 meses.
Nombre de modelo	‎IS-986
Usuarios sugeridos	‎Niños
Fabricante	‎KDJ
Año del modelo	‎2021
Componentes incluidos	‎1 caja de embalaje colorida, 3 bloques de carretera, 2 llaves, 2 tornillos, 2 núcleos magnéticos, 1 patines en línea ajustables KDJ, 1 par de plantillas para zapatos
Tamaño	‎L
Tipo de deporte	‎Patinaje
Nivel de habilidad	‎Expert